11111111111111111111111
1000C0000000C0110C00101
100010C000CC01000C010C1
1CP010010C00C0000010C01
10001001000C11CC0001001
100000C0000101C0C00C101
100000C000010C000C00001
1000000000CC0EC0000C001
11111111111111111111111
